000000000
001000000
011100000
001000000
000000000
001000100
011101110
001000100
000000000