1010100110
0110101011
1100001000
1011111110
1011110111
1011100001
0100110111
1011001101