0000000000
0111110000
0111000110
0000000110
0000000000